10.bx
..........
..........
.....bb...
....b.....
......b..
.b.......b
b.......b.
b..b......
bb...b....
.bb.b...b.

