30.ox
o....oo...o.o.o..ooo...o....oo
...o..oo......oo.o..o......o.o
ooo........o..o.o..oo......ooo
o......oo...o....oooo..o....o.
......oo.........o..o.....o...
.o....o.......o.o.oooo...ooo..
.oo.o.oo.ooo.....oo.ooo.o.o.o.
oo...o.o...o..o.o..oooo....oo.
..ooo.oo....o..o.oo..o........
...o.oooo.....ooo..o........o.
o............oooo.o.o..oo.o.oo
o....o...oo....o.o....o.o.....
..o.o...o...oo..ooo......o....
o....o.........o...o....oo....
oo..o.......ooo...o...o.ooo.oo
o.o.....oo..oo.oo....o.oo.oo.o
.o.o..o.oo.oo..o.oo.oo.o.o.o.o
.o.o.....oo.o.o...o..o.oo....o
....o..oo..o...oo..o....o.o...
oo.o............o...o..oo..o..
.........o..o.oo..ooo..o..o..o
..o.ooooo...o.o...o.oo.o.o.ooo
.o....o...oooo..o......o.o....
o...ooo.....oo..o....o..ooo..o
.o...oo.o.....o.o.....o......o
o...oo.........o..o.......o...
oo.....oo.....o....oo.oo......
.........o......oo.o.oo.o.o.o.
o.o..o...o.o.....o.oo...oo..o.
..oo...o.oo.ooo..oo.o.o......o

